######################################################################
#                             #           #           ################
############################# ########### # ############    ###     4
#       ########            # #           #                     ######
#       ########            # #           #           ######### ######
####### ######## ############ #           #           ####        ####
#                             #           #           ######### ######
#######################################################              #
#                  ####################################              #
#                  ###########################################       #
#      ###############################################################
#      ####### #######################################################
############ # # #######            ###   ####### ###      ###########
########### ## ## ###### ############## ## ###### ### ##### ##########
########## ### ### ##### ############## ### ##### ### ###### #########
######### #### #### ####            ### #### #### ### ####### ########
############## ######### ############## ##### ### ### ####### ########
############## ######### ############## ###### ## ### ##### ##########
############## #########            ### #######   ###      ###########
######################################################################