#########################################
     #          #            #      #    
###      ###    #   ##########  #   #   #
#    #######    #   #           #   #   #
#    #                  #########   #   #
#    ####################               #
#    ###        #           #  #    #####
#    ###   #        #########  #        #
#    ###   ##########   #      #    #   #
#                       #   ####    #   #
#########################################