######################################################################
# #    #     ##  #     ##   ##  #   ####       ####                  #
#   # #  # #   # # #### ### ### # #    # # #   #    # ############## #
# ###  #  #  # # #    #     #   # #  # #  #####  ## #       # ##  #  #
#   ##  # ###  # ## # # ## #  # #  ###  #       #   # # # ### #  #  ##
# #  ##   #   #  # #  #  #   #   #   ##  ####  #  ##  # ### # # #  # #
# ##  ## ## ##  #   ## #  ##  #  ### # #   #  #  #####  #     #   ## #
# # #   # #   # # #     #   #  #     #   #   #        ######## ##    #
# #  ## # # # # # # # ## # ## ## ######### ##########     ##   #  ## #
#  #    # # # # #  ## #    # # #      #           # ### #    ##  # # #
##  # ##  ##  #  # #  # # #  #  ######  ######### #   # ######  ##   2
#  # # # ####  # # ###  #  # ##    #  #         #  ## #        #   ###
# #    #    ##   # #  #  # # # # #  #####  # ##  #  #  ####### #   ###
#   ##  # #  #####  #  #  #  # ## #    # ########## ##       #   #   #
# ## ##  # # ##   # ##  #  # #      ## #     #      # ###### ###  # ##
# ##  ## #   #  #   # #  #   ###### #  # ###  # #####      #    ##   #
#   #  # # ##  #  # #     ##        # #     # #     #  ###  ###   ## #
# #  # # # #  #  ## # ###    ###### # ##### # ##### # #        ## #  2
#  #   #     #  #       # # #       #       #         # #  ###     # #
######################################################################
